50 50
24 47
10 5  5  5  5  5  5  5  5  5  11 16 16 16 16 16 10 5  5  11 16 10 5  5  5  5  5  5  5  5  5  11 16 16 16 16 16 16 16 10 5  5  5  5  5  5  5  5  5  11
3  0  0  0  0  0  0  99 99 0  2  16 16 16 16 10 9  99 0  8  5  9  0  0  0  0  0  0  0  0  0  8  11 16 16 16 16 16 16 3  99 0  0  0  0  0  0  99 0  8
3  0  99 0  0  0  0  99 0  0  8  11 16 16 10 9  0  0  0  0  0  0  0  0  99 0  0  0  0  0  0  0  8  5  5  11 16 16 16 3  0  0  99 0  0  0  0  0  0  0
3  0  0  0  99 0  0  0  0  0  0  8  5  5  9  0  0  0  6  4  4  4  4  4  4  4  4  7  0  0  0  99 0  0  0  2  16 16 16 3  0  0  0  0  0  0  0  0  99 99
3  99 0  0  0  0  99 0  0  99 0  0  0  0  0  0  0  6  13 16 16 16 16 16 16 16 16 3  0  0  0  0  0  99 0  2  16 10 5  9  99 0  0  0  0  0  0  1  1  6
3  0  0  0  99 0  0  0  0  0  99 0  0  0  0  99 99 8  11 16 16 16 16 16 16 16 16 12 7  0  0  0  0  0  0  8  11 3  0  0  0  0  0  0  99 0  1  1  1  2
3  0  99 0  0  0  99 0  0  0  0  0  99 0  0  0  0  0  8  5  5  5  11 16 16 16 16 16 12 4  4  4  4  7  0  0  8  9  0  6  4  7  0  0  0  0  1  1  1  2
3  0  99 0  0  0  0  99 0  99 0  0  0  0  99 99 0  0  99 0  0  0  2  16 16 16 16 16 16 16 16 16 16 12 7  0  0  0  0  2  16 3  0  99 0  0  1  1  1  2
3  0  0  0  99 0  0  0  99 0  99 0  0  0  0  0  0  0  99 0  0  0  2  16 16 16 16 16 16 16 16 16 16 16 12 7  0  0  0  2  16 12 4  4  4  4  4  4  4  13
3  0  0  0  0  99 0  0  0  99 0  0  99 0  99 99 0  99 0  0  0  0  8  5  5  5  11 16 16 16 16 16 16 16 16 12 4  4  4  13 16 16 16 16 16 16 16 16 16 16
3  99 0  0  0  99 0  99 0  99 0  0  0  99 0  0  99 0  0  0  0  0  0  0  0  0  2  16 16 16 16 16 16 16 16 16 16 16 16 16 16 16 16 16 16 16 16 16 16 16
3  0  0  0  99 0  0  0  0  0  0  99 0  0  0  0  0  0  0  0  0  0  0  0  0  0  8  5  11 16 16 16 16 16 16 16 16 16 16 16 16 16 16 16 16 16 16 16 16 16
3  0  99 0  0  99 0  99 0  0  0  0  0  0  0  0  0  0  0  0  0  0  0  0  0  0  0  0  8  5  5  5  11 16 16 16 16 16 16 16 16 16 16 16 16 16 16 16 16 16
3  0  99 99 0  0  0  0  0  0  0  0  0  0  0  0  0  0  0  0  0  0  0  0  0  0  0  0  0  0  0  0  2  16 16 16 16 16 16 16 16 16 16 16 16 16 16 16 16 16
3  0  0  0  99 0  0  0  0  0  0  0  0  0  0  0  0  0  0  0  0  0  6  4  7  0  0  0  0  0  0  0  2  16 16 16 16 16 16 16 16 16 16 16 16 16 10 5  5  11
3  99 0  0  99 0  0  0  0  0  0  0  0  0  0  0  0  0  0  0  0  0  2  16 3  0  0  0  0  0  0  0  2  16 16 16 16 16 16 16 16 16 16 16 16 16 3  1  1  2
3  0  0  0  99 0  0  99 0  0  0  0  0  0  0  0  0  0  0  0  0  0  2  16 3  0  0  0  0  0  99 0  8  11 16 16 16 16 16 16 16 16 16 16 16 16 3  1  1  2
3  0  99 0  0  0  0  0  0  0  0  0  0  0  0  0  0  0  0  0  0  0  2  16 12 7  0  0  0  0  0  0  0  2  16 16 16 16 16 16 16 16 16 16 16 10 9  1  1  2
3  0  0  0  0  99 0  0  0  0  0  0  0  0  0  0  0  0  0  0  6  4  13 16 16 3  0  0  0  0  0  0  0  2  16 16 16 16 16 16 16 16 16 16 10 9  0  1  1  2
3  99 0  99 0  0  99 0  0  0  0  0  6  4  4  7  0  0  0  0  2  16 16 16 16 3  0  0  0  0  0  0  0  8  5  11 16 16 16 16 16 16 16 10 9  0  0  0  1  2
3  0  99 0  99 0  99 0  0  0  0  0  2  16 16 12 7  0  0  0  8  11 16 10 5  9  0  0  0  0  0  0  0  0  0  2  16 16 16 16 16 16 16 3  0  0  0  0  0  2
3  0  99 0  0  0  0  0  0  0  0  6  13 16 16 16 3  0  0  0  0  8  5  9  0  0  0  0  0  0  0  0  0  0  0  2  16 16 16 16 16 16 10 9  0  0  0  0  0  2
3  99 0  0  0  0  0  0  0  0  0  8  11 16 16 10 9  0  0  0  0  0  0  0  0  0  0  0  0  0  0  0  0  0  0  2  16 16 16 16 16 10 9  0  0  0  0  0  0  2
3  0  0  0  0  0  0  0  0  0  0  0  2  16 16 3  0  0  0  0  0  0  0  0  0  0  0  0  0  99 0  0  0  0  0  8  5  5  5  5  5  9  0  0  0  99 0  0  0  2
3  0  0  99 99 0  0  0  0  0  0  0  8  5  5  9  0  0  0  0  0  99 0  0  0  0  0  0  0  0  0  0  0  0  0  0  0  0  0  0  0  0  0  0  0  0  0  0  0  2
3  99 1  1  6  4  7  0  0  0  0  0  0  0  0  0  0  0  0  0  0  99 0  0  0  0  0  0  0  0  0  0  0  0  0  0  0  0  0  0  0  0  0  0  0  0  0  0  0  2
3  99 1  1  2  16 12 4  4  7  0  0  0  0  0  0  0  0  0  0  0  99 0  0  0  0  0  0  0  0  0  0  0  0  0  0  0  0  0  0  0  0  0  0  0  0  0  99 0  2
3  1  6  4  13 16 16 16 16 3  0  0  0  0  0  0  0  0  0  0  0  99 99 99 99 99 0  0  0  0  0  99 0  0  0  0  0  0  0  0  0  0  0  99 0  0  0  0  0  2
12 4  13 16 16 16 16 16 16 3  0  0  0  0  0  0  0  0  0  99 96 96 96 96 98 1  1  0  0  0  0  0  0  0  0  0  0  0  0  0  0  0  0  0  0  0  0  0  0  2
16 16 16 16 16 16 16 16 16 12 7  0  0  0  0  0  0  0  0  1  99 98 1  1  1  1  0  0  0  0  0  0  0  0  0  6  4  4  4  4  4  7  0  0  0  0  0  0  0  2
16 16 16 16 16 16 16 16 16 16 3  0  0  0  0  0  0  0  0  0  0  0  1  1  1  0  0  0  0  0  0  0  0  0  0  2  16 16 16 16 16 3  0  0  0  0  0  0  0  2
16 16 16 16 10 5  5  5  11 16 12 7  0  0  0  0  0  0  0  0  0  0  0  1  1  0  0  0  0  0  0  0  0  0  0  2  16 16 16 16 16 3  0  0  0  0  0  0  0  2
16 16 16 16 3  1  1  1  2  16 10 9  0  0  0  0  0  0  0  0  0  0  0  0  0  0  0  0  0  0  0  0  99 0  0  2  16 16 16 16 16 12 7  0  0  0  0  0  0  2
16 16 16 10 9  1  1  1  8  5  9  0  0  0  0  0  0  0  0  0  0  0  0  0  0  0  0  0  0  0  0  0  6  4  4  13 16 16 16 16 16 16 3  0  99 0  0  0  0  2
16 16 16 3  0  0  0  0  0  0  0  0  0  0  0  0  0  0  0  0  0  0  0  0  0  0  0  0  0  99 0  6  13 16 16 16 16 16 16 16 16 16 3  0  0  0  0  0  0  2
16 16 16 3  0  0  0  0  0  0  0  0  0  6  4  4  7  0  0  0  0  0  0  0  0  0  0  0  0  99 0  2  16 16 16 16 16 16 16 16 16 16 3  0  0  0  0  0  0  2
10 5  5  9  0  0  0  0  0  0  0  0  0  2  16 16 3  0  0  0  0  0  0  0  0  0  0  0  1  1  1  2  16 16 16 16 16 16 16 16 16 16 3  0  0  0  0  0  0  2
3  0  0  0  0  0  0  0  0  0  0  0  0  2  16 16 12 4  4  4  7  99 0  0  0  0  0  1  1  1  1  2  16 16 16 16 16 16 16 16 16 16 3  0  0  0  0  0  1  2
3  0  0  0  0  0  0  99 0  0  0  0  0  2  16 16 16 16 16 16 12 7  99 0  0  1  1  1  1  99 0  2  16 16 16 16 16 16 16 16 16 16 12 4  4  7  1  1  1  2
3  0  0  0  0  0  0  0  0  0  0  0  0  2  16 16 16 16 16 16 16 3  99 0  0  1  1  1  99 98 0  2  16 16 16 16 16 16 16 16 16 16 16 16 16 3  1  1  1  2
3  0  0  0  0  99 0  0  0  0  0  0  0  2  16 16 16 16 16 16 16 12 7  1  0  1  1  99 98 0  6  13 16 16 16 16 16 16 16 16 16 16 16 16 16 3  1  1  1  2
3  0  0  0  0  0  0  0  0  0  0  0  0  2  16 16 16 16 16 16 16 16 3  0  0  1  1  6  4  4  13 16 16 16 16 16 16 16 16 16 16 16 16 16 16 3  1  1  1  2
3  0  0  0  0  0  0  0  99 0  0  0  6  13 16 16 16 16 16 16 16 16 3  0  0  0  6  13 16 16 16 16 16 16 16 16 16 16 16 16 16 16 16 16 16 12 4  4  4  13
3  0  0  0  0  0  0  0  0  0  0  0  2  16 16 16 16 16 16 16 16 16 3  0  0  0  2  16 16 16 16 16 16 16 16 16 16 16 16 16 16 16 16 16 16 16 16 16 16 16
3  1  1  0  0  0  99 0  0  0  0  0  2  16 16 16 16 16 16 16 16 16 3  0  0  0  2  16 16 16 16 16 16 16 16 16 16 16 16 16 16 16 16 16 16 16 16 16 16 16
3  1  1  1  1  0  0  0  0  0  0  0  2  16 16 16 16 16 16 16 16 16 3  0  0  0  2  16 16 16 16 16 16 16 16 16 16 16 16 16 16 16 16 16 16 16 16 16 16 16
3  1  1  1  1  1  0  0  0  0  1  1  2  16 16 16 16 16 16 16 16 16 3  0  0  0  2  16 16 16 16 16 16 16 16 16 16 16 16 16 16 16 16 16 16 16 16 16 16 16
12 4  7  1  1  1  1  1  1  1  1  6  13 16 16 16 16 16 16 16 16 16 3  0  0  0  2  16 16 16 16 16 16 16 16 16 16 16 16 16 16 16 16 16 16 16 16 16 16 16
16 16 12 7  1  1  1  1  1  1  1  2  16 16 16 16 16 16 16 16 16 16 3  0  0  0  2  16 16 16 16 16 16 16 16 16 16 16 16 16 16 16 16 16 16 16 16 16 16 16
16 16 16 12 4  4  4  4  4  4  4  13 16 16 16 16 16 16 16 16 16 16 12 4  4  4  13 16 16 16 16 16 16 16 16 16 16 16 16 16 16 16 16 16 16 16 16 16 16 16
